Time, File, Conversion, Render, Resize, Total, Status
3/18/2019 3:49:31 PM, 100SlidePowerPointPres.ppt, 224, 2, 13, 239, Ok
3/18/2019 3:49:32 PM, 131814.xls, 38, 2, 15, 55, Ok
3/18/2019 3:49:32 PM, 1excel 2003.xls, 19, 2, 15, 36, Ok
3/18/2019 3:49:32 PM, 1PPT 2003.ppt, 131, 2, 12, 145, Ok
3/18/2019 3:49:32 PM, 1PPTX 2003.pot, 69, 1, 13, 83, Ok
3/18/2019 3:49:32 PM, 1Read only excel 2003.xls, 17, 2, 15, 34, Ok
3/18/2019 3:49:32 PM, 1Read Only Word 2003.doc, 51, 1, 16, 68, Ok
3/18/2019 3:49:32 PM, 1Template excel 2003.xlt, 18, 3, 15, 36, Ok
3/18/2019 3:49:32 PM, 1Word 2003 template.dot, 41, 2, 16, 59, Ok
3/18/2019 3:49:32 PM, 1Word 2003.doc, 46, 2, 16, 64, Ok
3/18/2019 3:49:32 PM, 2003PowerPointPres.PPT, 14, 2, 13, 29, Ok
3/18/2019 3:49:33 PM, 2016 32bit file_colors.docx, 412, 2, 16, 430, Ok
3/18/2019 3:49:33 PM, 2016 32bit file_colors_111.odt, 0, 0, 0, 0, Error
3/18/2019 3:49:33 PM, 2018.05.25.00.03.04(1).xlsx, 198, 2, 16, 216, Ok
3/18/2019 3:49:33 PM, 2018.05.25.00.03.04.xlsx, 51, 2, 15, 68, Ok
3/18/2019 3:49:34 PM, 29 pages.docx, 152, 2, 16, 170, Ok
3/18/2019 3:49:34 PM, 3 - PrepareForMigration.ppsx, 324, 1, 13, 338, Ok
3/18/2019 3:49:34 PM, 3_original.xls, 521, 2, 15, 538, Ok
3/18/2019 3:49:35 PM, 479 Pages.doc, 487, 2, 16, 505, Ok
3/18/2019 3:49:35 PM, 4_original.xlsx, 17, 2, 16, 35, Ok
3/18/2019 3:49:35 PM, 5_original_2007template.xltx, 108, 2, 15, 125, Ok
3/18/2019 3:49:36 PM, 719 Pages.doc, 750, 2, 16, 768, Ok
3/18/2019 3:49:36 PM, all keyboard chars.DOC, 26, 2, 15, 43, Ok
3/18/2019 3:49:36 PM, Binary2016.xlsx, 35, 2, 16, 53, Ok
3/18/2019 3:49:36 PM, Buddy Requirement.DOC, 94, 2, 16, 112, Ok
3/18/2019 3:49:37 PM, Calorie amortization schedule1.xlsx, 469, 2, 15, 486, Ok
3/18/2019 3:49:37 PM, ClaimsAdmin.pptx, 139, 2, 13, 154, Ok
3/18/2019 3:49:37 PM, ClaimsAdmin2016.pptx, 59, 2, 13, 74, Ok
3/18/2019 3:49:37 PM, ColoredFonts.xlsx, 12, 2, 16, 30, Ok
3/18/2019 3:49:37 PM, ColoredFonts.zip, 0, 0, 0, 0, Error
3/18/2019 3:49:37 PM, created by pam - readonly - final.docx, 30, 2, 16, 48, Ok
3/18/2019 3:49:37 PM, DOC 2013.doc, 24, 2, 15, 41, Ok
3/18/2019 3:49:37 PM, DOCM 2013.docm, 227, 2, 16, 245, Ok
3/18/2019 3:49:40 PM, Document less 5mb-2013.dotm, 2524, 2, 17, 2543, Ok
3/18/2019 3:49:40 PM, Document Preview-2013.xlsx, 11, 2, 7, 20, Ok
3/18/2019 3:49:40 PM, DOCX 2013.docx, 0, 0, 0, 0, Error
3/18/2019 3:49:40 PM, DOT 2013.dot, 136, 2, 15, 153, Ok
3/18/2019 3:49:41 PM, DOTM 2013.dotm, 483, 1, 15, 499, Ok
3/18/2019 3:49:41 PM, DOTX 2013.dotx, 68, 2, 16, 86, Ok
3/18/2019 3:49:41 PM, EmptyDoc 2003.doc, 13, 2, 18, 33, Ok
3/18/2019 3:49:41 PM, Emptyexcel2003.xls, 10, 2, 16, 28, Ok
3/18/2019 3:49:41 PM, emptyexceltemplate2003.xlt, 9, 2, 17, 28, Ok
3/18/2019 3:49:41 PM, emptyppt.ppt, 9, 2, 13, 24, Ok
3/18/2019 3:49:47 PM, Entire_Gutenberg_Twain_Texts.rtf, 6341, 0, 17, 6358, Ok
3/18/2019 3:49:47 PM, excel 2003.xls, 17, 0, 16, 33, Ok
3/18/2019 3:49:47 PM, Excel 2007 read only.xlsx, 59, 0, 17, 76, Ok
3/18/2019 3:49:47 PM, Excel 2007 template.xltm, 56, 0, 17, 73, Ok
3/18/2019 3:49:48 PM, Excel 2007 template.xltx, 61, 0, 17, 78, Ok
3/18/2019 3:49:48 PM, Excel 2007.xlsb, 0, 0, 0, 0, Error
3/18/2019 3:49:48 PM, Excel 2007.xlsm, 60, 2, 17, 79, Ok
3/18/2019 3:49:48 PM, Excel 2007.xlsx, 58, 2, 17, 77, Ok
3/18/2019 3:49:48 PM, excel 2010.xlsb, 0, 0, 0, 0, Error
3/18/2019 3:49:48 PM, excel 2010.xlsm, 33, 2, 18, 53, Ok
3/18/2019 3:49:48 PM, excel 2010.xlsx, 35, 2, 16, 53, Ok
3/18/2019 3:49:48 PM, excel 2016.xlsx, 34, 2, 16, 52, Ok
3/18/2019 3:49:48 PM, excel 2016_1page.xls, 21, 2, 32, 55, Ok
3/18/2019 3:49:48 PM, excel1 2003.XLS, 17, 2, 16, 35, Ok
3/18/2019 3:49:48 PM, Excel1 2007 template.XLTM, 58, 2, 16, 76, Ok
3/18/2019 3:49:48 PM, Excel1 2007.XLSM, 61, 2, 17, 80, Ok
3/18/2019 3:49:48 PM, excel1 2010.XLSB, 0, 0, 0, 0, Error
3/18/2019 3:49:48 PM, excel2013_empty.xlsx, 9, 2, 17, 28, Ok
3/18/2019 3:49:48 PM, Excel_5worksheets_500rows.xls, 102, 2, 16, 120, Ok
3/18/2019 3:49:49 PM, Excel_5worksheets_500rows.xlsx, 523, 1, 15, 539, Ok
3/18/2019 3:49:49 PM, given_simple_pp_macro_template.POTM, 23, 2, 13, 38, Ok
3/18/2019 3:49:49 PM, given_simple_pp_template.POTX, 24, 2, 14, 40, Ok
3/18/2019 3:49:49 PM, ImageRight MINT POC Issues-2013.xlt, 23, 3, 13, 39, Ok
3/18/2019 3:49:49 PM, ImageRightFaxCover.dot, 75, 2, 16, 93, Ok
3/18/2019 3:49:49 PM, IR Viewer Retail-2013.potx, 64, 2, 15, 81, Ok
3/18/2019 3:49:49 PM, IR Viewer Retail-2013.ppsx, 140, 2, 14, 156, Ok
3/18/2019 3:49:50 PM, IR Viewer Retail-2013.pptm, 306, 2, 14, 322, Ok
3/18/2019 3:49:50 PM, IR Viewer Retail-2013.pptx, 81, 2, 14, 97, Ok
3/18/2019 3:49:54 PM, Large.xlsx, 3689, 2, 16, 3707, Ok
3/18/2019 3:50:00 PM, LargeBook1.xlsx, 6217, 0, 17, 6234, Ok
3/18/2019 3:50:00 PM, Macro 2016.xlsm, 31, 0, 15, 46, Ok
3/18/2019 3:50:00 PM, macro2016.pptm, 114, 0, 13, 127, Ok
3/18/2019 3:50:00 PM, Macroword 2016.docm, 153, 2, 16, 171, Ok
3/18/2019 3:50:00 PM, Mad kitty.docx, 56, 2, 18, 76, Ok
3/18/2019 3:50:00 PM, OCR FAQ - 2013.dotx, 76, 2, 16, 94, Ok
3/18/2019 3:50:00 PM, OCR Workflow Scripting-2013.docm, 64, 2, 16, 82, Ok
3/18/2019 3:50:01 PM, POT 2013.pot, 13, 2, 15, 30, Ok
3/18/2019 3:50:01 PM, POTM 2013.potm, 37, 3, 14, 54, Ok
3/18/2019 3:50:01 PM, POTX 2013.potx, 52, 2, 14, 68, Ok
3/18/2019 3:50:01 PM, powerpoint file in ppSm (show .PPSM, 192, 2, 13, 207, Ok
3/18/2019 3:50:01 PM, powerpoint file in ppSm (show macro)format.ppsm, 190, 2, 13, 205, Ok
3/18/2019 3:50:01 PM, powerpoint file in ppSx (show )format.ppsx, 189, 2, 13, 204, Ok
3/18/2019 3:50:02 PM, powerpoint file in ppSx (show .PPSX, 185, 2, 13, 200, Ok
3/18/2019 3:50:02 PM, powerpoint file in pptm (macro)format.pptm, 190, 2, 13, 205, Ok
3/18/2019 3:50:02 PM, powerpoint file in pptm (macro.PPTM, 186, 2, 13, 201, Ok
3/18/2019 3:50:02 PM, powerpoint file in pptx format.pptx, 187, 2, 13, 202, Ok
3/18/2019 3:50:02 PM, PPS.pps, 29, 2, 14, 45, Ok
3/18/2019 3:50:03 PM, PPSM 2013.ppsm, 361, 2, 14, 377, Ok
3/18/2019 3:50:03 PM, PPSX 2013.ppsx, 131, 2, 14, 147, Ok
3/18/2019 3:50:03 PM, PPT 2003 read-only.ppt, 124, 1, 13, 138, Ok
3/18/2019 3:50:03 PM, PPT 2003.ppt, 122, 2, 13, 137, Ok
3/18/2019 3:50:03 PM, PPT 2013.ppt, 28, 2, 14, 44, Ok
3/18/2019 3:50:03 PM, PPT2013_empty.pptx, 24, 2, 14, 40, Ok
3/18/2019 3:50:03 PM, PPTM.pptm, 26, 2, 14, 42, Ok
3/18/2019 3:50:03 PM, PPTX 2003.POT, 10, 2, 13, 25, Ok
3/18/2019 3:50:04 PM, PPTX 2007.pptm, 195, 1, 13, 209, Ok
3/18/2019 3:50:04 PM, PPTX 2007.pptx, 196, 1, 13, 210, Ok
3/18/2019 3:50:04 PM, pptx 2010 - read-only-final.pptx, 116, 2, 13, 131, Ok
3/18/2019 3:50:04 PM, pptx 2010.pptm, 118, 2, 13, 133, Ok
3/18/2019 3:50:04 PM, pptx 2010.pptx, 114, 2, 13, 129, Ok
3/18/2019 3:50:04 PM, PPTX 2013.pptx, 95, 1, 14, 110, Ok
3/18/2019 3:50:05 PM, Print Screen.doc, 60, 2, 16, 78, Ok
3/18/2019 3:50:05 PM, Read only excel 2003.xls, 15, 2, 15, 32, Ok
3/18/2019 3:50:05 PM, read only excel 2010.xlsx, 31, 3, 16, 50, Ok
3/18/2019 3:50:05 PM, read only excel 2016.xlsx, 32, 2, 16, 50, Ok
3/18/2019 3:50:05 PM, Read only excel1 2003.XLS, 18, 2, 14, 34, Ok
3/18/2019 3:50:05 PM, Read Only Word 2003.doc, 44, 2, 16, 62, Ok
3/18/2019 3:50:05 PM, read only word 2010.docx, 73, 2, 16, 91, Ok
3/18/2019 3:50:05 PM, read only word 2016.docx, 91, 2, 16, 109, Ok
3/18/2019 3:50:05 PM, Read-only-2013.xlsx, 34, 2, 16, 52, Ok
3/18/2019 3:50:05 PM, read-only-YN-2013.docm, 106, 2, 16, 124, Ok
3/18/2019 3:50:05 PM, read-only2016.pptx, 129, 2, 13, 144, Ok
3/18/2019 3:50:05 PM, readonly.docx, 34, 1, 15, 50, Ok
3/18/2019 3:50:06 PM, RTF 2013.rtf, 132, 2, 16, 150, Ok
3/18/2019 3:50:06 PM, Scenarios-2013.xlsm, 60, 1, 16, 77, Ok
3/18/2019 3:50:06 PM, SimpleExcelWorksheet.xlsx, 57, 2, 16, 75, Ok
3/18/2019 3:50:06 PM, Template excel 2003.xlt, 17, 2, 15, 34, Ok
3/18/2019 3:50:06 PM, Template excel1 2003.XLT, 16, 2, 15, 33, Ok
3/18/2019 3:50:06 PM, Test FIle.xltx, 10, 2, 16, 28, Ok
3/18/2019 3:50:06 PM, TEST-MULTIPAGE.docx, 43, 2, 15, 60, Ok
3/18/2019 3:50:06 PM, TEST.docx, 42, 2, 16, 60, Ok
3/18/2019 3:50:06 PM, test.xlsx, 16, 2, 16, 34, Ok
3/18/2019 3:50:06 PM, Test1.ppt, 123, 2, 13, 138, Ok
3/18/2019 3:50:06 PM, Test1.xls, 13, 2, 16, 31, Ok
3/18/2019 3:50:06 PM, Test1_2013.pptm, 122, 2, 14, 138, Ok
3/18/2019 3:50:07 PM, Test2.PPT, 123, 2, 13, 138, Ok
3/18/2019 3:50:07 PM, Test2.xls, 10, 3, 15, 28, Ok
3/18/2019 3:50:07 PM, Test3Large.XLS, 0, 0, 0, 0, Error
3/18/2019 3:50:07 PM, This is a docm file.docm, 50, 2, 16, 68, Ok
3/18/2019 3:50:08 PM, This is a great spot for a mission statement-2013.docx, 0, 0, 0, 0, Error
3/18/2019 3:50:08 PM, Trouble adding Burn Queues.docx, 95, 2, 15, 112, Ok
3/18/2019 3:50:12 PM, twainmaretext02mtent13rtf.rtf, 4162, 1, 15, 4178, Ok
3/18/2019 3:50:13 PM, Waterton Final WS.xls, 549, 1, 15, 565, Ok
3/18/2019 3:50:13 PM, Wedding budget1-2013.xlsb, 0, 0, 0, 0, Error
3/18/2019 3:50:13 PM, Werbung_1.PPS, 53, 2, 13, 68, Ok
3/18/2019 3:50:13 PM, Word 2003 read-only-final.DOC, 42, 2, 15, 59, Ok
3/18/2019 3:50:13 PM, Word 2003 template.DOT, 35, 1, 16, 52, Ok
3/18/2019 3:50:13 PM, Word 2003.doc, 44, 2, 16, 62, Ok
3/18/2019 3:50:13 PM, Word 2003.one page.doc, 44, 2, 16, 62, Ok
3/18/2019 3:50:13 PM, Word 2007 read only.docx, 42, 2, 16, 60, Ok
3/18/2019 3:50:13 PM, Word 2007 template.DOTM, 64, 1, 14, 79, Ok
3/18/2019 3:50:13 PM, Word 2007 template.dotx, 31, 1, 14, 46, Ok
3/18/2019 3:50:13 PM, Word 2007.docx, 45, 1, 15, 61, Ok
3/18/2019 3:50:13 PM, Word 2010 Template.DOTX, 47, 2, 16, 65, Ok
3/18/2019 3:50:13 PM, word 2010.docm, 72, 2, 15, 89, Ok
3/18/2019 3:50:13 PM, word 2010.docx, 89, 2, 16, 107, Ok
3/18/2019 3:50:15 PM, Word_250 pages.docx, 1249, 2, 16, 1267, Ok
3/18/2019 3:50:18 PM, Word_500 pages.doc, 3482, 3, 16, 3501, Ok
3/18/2019 3:50:21 PM, Word_500 pages.docx, 2792, 2, 18, 2812, Ok
3/18/2019 3:50:21 PM, XLS 2013.xls, 44, 2, 16, 62, Ok
3/18/2019 3:50:21 PM, XLSB 2013.xlsb, 0, 0, 0, 0, Error
3/18/2019 3:50:21 PM, xlsB formated workbook.xlsb, 0, 0, 0, 0, Error
3/18/2019 3:50:21 PM, XLSM 2013.xlsm, 161, 17, 18, 196, Ok
3/18/2019 3:50:21 PM, xlsM formated workbook.xlsm, 12, 2, 17, 31, Ok
3/18/2019 3:50:21 PM, XLT 2013.xlt, 17, 3, 17, 37, Ok
3/18/2019 3:50:22 PM, XLTM 2013.xltm, 71, 2, 16, 89, Ok
3/18/2019 3:50:23 PM, XLTX 2013.xltx, 1689, 2, 15, 1706, Ok
3/18/2019 3:50:23 PM, XSLX 2016.xlsx, 137, 2, 16, 155, Ok
